1111111111
1200000011
1111111011
1000000001
1101101111
1000100011
1010101011
1010101011
1001011031
1111111111
